################
#..............#
#..............#
#....####......#
#..............#
#.......##.....#
#..............#
#..............#
#..............#
################
